{
    title: "Valley of Bones",
    description: "The original valley of bones.",
    width: 19,
    height: 13,
    tilewidth: 64,
    tileheight: 64,
    version: 1,
    tiles: ["dirt-hex", "metal-hex"],
    tilelayers:
    [
        {
            visible: true,
            collidable: false,
            name: "background",
            opacity: 1,
            data:
            [
                0, 0, 0, 0, 0, 0, 0, 0, 0, 0, 0, 0, 0, 0, 0, 0, 0, 0, 0,
                0, 0, 0, 0, 0, 0, 0, 0, 0, 0, 0, 0, 0, 0, 0, 0, 0, 0, 0,
                0, 0, 0, 0, 0, 0, 0, 0, 0, 0, 0, 0, 0, 0, 0, 0, 0, 0, 0,
                0, 0, 0, 0, 0, 0, 0, 0, 0, 0, 0, 0, 0, 0, 0, 0, 0, 0, 0,
                0, 0, 0, 0, 0, 0, 0, 0, 0, 0, 0, 0, 0, 0, 0, 0, 0, 0, 0,
                0, 0, 0, 0, 0, 0, 0, 0, 0, 0, 0, 0, 0, 0, 0, 0, 0, 0, 0,
                0, 0, 0, 0, 0, 0, 0, 0, 0, 0, 0, 0, 0, 0, 0, 0, 0, 0, 0,
                0, 0, 0, 0, 0, 0, 0, 0, 0, 0, 0, 0, 0, 0, 0, 0, 0, 0, 0,
                0, 0, 0, 0, 0, 0, 0, 0, 0, 0, 0, 0, 0, 0, 0, 0, 0, 0, 0,
                0, 0, 0, 0, 0, 0, 0, 0, 0, 0, 0, 0, 0, 0, 0, 0, 0, 0, 0,
                0, 0, 0, 0, 0, 0, 0, 0, 0, 0, 0, 0, 0, 0, 0, 0, 0, 0, 0,
                0, 0, 0, 0, 0, 0, 0, 0, 0, 0, 0, 0, 0, 0, 0, 0, 0, 0, 0,
                0, 0, 0, 0, 0, 0, 0, 0, 0, 0, 0, 0, 0, 0, 0, 0, 0, 0, 0,
            ],
        },
        {
            visible: true,
            collidable: false,
            traversible: true,
            name: "map",
            opacity: 1,
            data: 
            [
                1, 1, 1, 1, 1, 1, 1, 1, 1, 1, 1, 1, 1, 1, 1, 1, 1, 1, 1,
                1, 1, 1, 1, 1, 1, 1, 1, 2, 2, 1, 1, 1, 1, 1, 1, 1, 1, 0,
                1, 1, 1, 1, 1, 1, 1, 1, 2, 2, 2, 1, 1, 1, 1, 1, 1, 1, 1,
                1, 1, 1, 1, 1, 1, 1, 1, 2, 2, 1, 1, 1, 1, 1, 1, 1, 1, 0,
                1, 1, 1, 1, 1, 1, 1, 1, 1, 1, 1, 1, 1, 1, 1, 1, 1, 1, 1,
                2, 2, 1, 2, 2, 1, 1, 1, 0, 0, 1, 1, 1, 2, 2, 1, 2, 2, 0,
                2, 2, 2, 2, 2, 2, 1, 1, 0, 0, 0, 1, 1, 2, 2, 2, 2, 2, 2,
                2, 2, 1, 2, 2, 1, 1, 1, 0, 0, 1, 1, 1, 2, 2, 1, 2, 2, 0,
                1, 1, 1, 1, 1, 1, 1, 1, 1, 1, 1, 1, 1, 1, 1, 1, 1, 1, 1,
                1, 1, 1, 1, 1, 1, 1, 1, 2, 2, 1, 1, 1, 1, 1, 1, 1, 1, 0,
                1, 1, 1, 1, 1, 1, 1, 1, 2, 2, 2, 1, 1, 1, 1, 1, 1, 1, 1,
                1, 1, 1, 1, 1, 1, 1, 1, 2, 2, 1, 1, 1, 1, 1, 1, 1, 1, 0,
                1, 1, 1, 1, 1, 1, 1, 1, 1, 1, 1, 1, 1, 1, 1, 1, 1, 1, 1,
            ],
        },
    ],
    objects:
    [
        {
            type: "spawn",
            player: 0,
            x: 1,
            y: 6,
        },
        {
            type: "spawn",
            player: 1,
            x: 17,
            y: 6,
        },
        {
            type: "unit",
            proto: "tower-base",
            player: -1,
            x: 4,
            y: 6,
        },
        {
            type: "unit",
            proto: "tower-base",
            player: -1,
            x: 14,
            y: 6,
        },
        {
            type: "unit",
            proto: "tower-base",
            player: -1,
            x: 9,
            y: 2,
        },
        {
            type: "unit",
            proto: "tower-base",
            player: -1,
            x: 9,
            y: 10,
        },
    ],
}
